1111111111111111111
1E00000000000000001
1010010100100000101
1010010010101010101
100000000C00C0000C1
1000000000000000001
1010010100100000101
1010010010101010101
1P0000000C00C0000C1
1111111111111111111