1111111111111111111
1E00000100000000C01
1111110100101111111
10000001000C0110001
111000010000C0000C1
1000000100000001111
1010010100100000101
1011111110001010101
1P0000000C00C1100C1
1111111111111111111