11111111111111111111111111111111111111
10001111111111111111111111111111110001
10E00111111111111111111111111111100C01
10000011111111111111111111111111000001
11000001111111111111111111111110000011
11100000111111111111111111111100000111
11110000011111111111111111111000001111
11111000001111111111111111110000011111
11111100000111111111111111100000111111
11111110000011111111111111000001111111
111111110000000000P0000000000011111111
11111111000000000000000000000011111111
11111110000011111111111111000001111111
11111100000111111111111111100000111111
11111000001111111111111111110000011111
11110000011111111111111111111000001111
11100000111111111111111111111100000111
11000001111111111111111111111110000011
10000011111111111111111111111111000001
10C00111111111111111111111111111100C01
10001111111111111111111111111111110001
11111111111111111111111111111111111111