11111111111111111111111111111111111
1E0000000000000C00000C0000000000001
10100101001000001010010000001010001
10100100101010100010010000001010001
100000000C00C000000000000000000C001
10100101001000001010010000001010001
10100100101010100010010000001010001
100000000C00C000000000000000000C001
100000000C00C000000000000000000C001
10100101001000001010010000001010001
10100100101010100P10010000001010001
100000000C00C000000000000000000C001
10100101001000001010010000001010001
10100100101010100010010000001010001
100000000C00C000000000000000000C001
11111111111111111111111111111111111