1111111111111111111111111111111111
1000000000000000001111111111111111
1000000000000000000001111111111111
111111111000011110000000011E000001
1111111110011000011100000000000001
1000000000011000011111110000000001
1010000000000000000C11111111111111
1000000000000000000011111111111111
1010000000000000011100000000000001
1000000000000000011100000000000001
1010000000000000000000000000000001
1000001111000000000000011100000001
10C00011110000000000000111000P0001
1000000000000000111100000000000001
1000000000000000111100000000000001
1111111111111111111111111111111111