111111111111111111111111111111111111
1E0000000000000C00000C00000000000001
101001010010000010100100000001010001
101001001010101000100100000001010001
100000000C00C0000000000000000000C001
101001010010000010100100000001010001
101001001010101000100100000001010001
100000000C00C0000000000000000000C001
101001010010000010100100000001010001
10100100101010100P100100000001010001
100000000C00C0000000000000000000C001
101001010010000010100100000001010001
101001001010101000100100000001010001
100000000C00C0000000000000000000C001
111111111111111111111111111111111111