11111111111111111111111111111111111111
1E0000000000000C00000C0000000000000001
10100101001000001010010000010100000001
10100100101010100010010000010100000001
100000000C00C00000000000000000C0000001
10100101001000001010010000010100000001
10100100101010100010010000010100000001
100000000C00C00000000000000000C0000001
1010010100100000101001P000010100000001
10100100101010100010010000010100000001
100000000C00C00000000000000000C0000001
10100101001000001010010000010100000001
10100100101010100010010000010100000001
10100100101010100010010000010100000001
100000000C00C00000000000000000C0000001
11111111111111111111111111111111111111