11111111111111111111111111111111111111
11111000000001111000111110000110C01001
10100101000000000000011110000110001001
1010010000000000C000011110000110001001
10000000110000000001111110011000001001
10100100100000001111100100011001001001
11111111101111001110000100011001001001
100E0P00001111001110C00100000000010001
11111111101111001110000100000100010001
10100100100000000000000100000100010001
10000000110000000000000100000000010001
10000000000000000000000000000000010001
10000000000000000000000011100000010001
10000001111111111111100000000000010001
111110000C0000000000100000000000010001
11111111111111111111111111111111111111