1111111111111111111111111111111111
1E0000000000000C0000C0000000000001
1010010100100000100010000001010001
1010010010101010000010000001010001
100000000C00C00000000000000000C001
1010010100100000100010000001010001
1010010010101010000010000001010001
100000000C00C00000000000000000C001
100000000C00C00000000000000000C001
1010010010101010000010000001010001
100000000C00C00000000000000000C001
100000000C00C00000000000000000C001
1010010010101010000010000001010001
100000000C00C00000000000000000C001
100000000C00C00000000000000000C001
1010010100100000100010000001010001
10100100101010100P1001000001010001
100000000C00C00000000000000000C001
1010010100100000101001000001010001
1010010010101010001001000001010001
100000000C00C00000000000000000C001
1111111111111111111111111111111111