1111111111111111111111111111111111
10CC00CC00CC0000000000000000000001
10CC00CC00CC0000000000000000000P01
10CC00CC00CC0000000000000000000001
10CC00CC00CC0000000000000000000001
10CC00CC00CC0000000000000000000001
1000000000000000000000000000000001
1000000000000000000000000000000001
1000000000001111111111000000000001
1000000000001111111111000000000001
1000000000110000000000110000000001
1000000000110000000000110000000001
1000000000111111111111000000000001
1000000000111111111111000000000001
1000000000110000000000001100000001
1000000000110000000000001100000001
1000000000001111111111110000000001
1000000000001111111111110000000001
1000000000000000000000000000000001
10E0000000000000000000000000000001
1000000000000000000000000000000001
1111111111111111111111111111111111