1111111111111
10010000000C1
1000011111001
1P00110C00001
1111111111111