1111111111111
10010000001C1
1000011110011
1P0011EC00001
1111111111111