1111111111111
1001000c000C1
1000011111001
1P0011EC00001
1111111111111